111111111
1C000P001
100000001
1000C0001
100000C01
1C000E001
111111111