111111111
10000P001
100000001
1000C0001
100000001
10000E001
1111111