111111111111111111111111111111111111111111111111111111111
1C000P00010000C000000000000010000000000000000000000000001
100111000100000000000000000010000000000000000000000011111
1011C1111100000000000000000010000000000000000000000000C01
100101E10000000000000000000010000000000000000000000010001
1C0100000000000000000000000010000000000000000000000010001
100000000000000000000000000010000000000000000000000000001
100000000000000000000000000000000000000000000000000000001
111111111111111111111111111111111111111111111111111111111