111111111
10000P001
10C000001
100000001
100000001
10000E001
1111111