111111111111111111111111111111111111111111111111111111111
1C000P00010000C000000000000000000000000000000000000000001
100000000100000000000000000000000000000000000000000011111
1000C0000100000000000000000000000000000000000000000000C01
100100C00000000000000000000000000000000000000000000010001
1C010E000000000000000000000000000000000000000000000010001
100000000000000000000000000000000000000000000000000000001
100000000000000000000000000000000000000000000000000000001
100000000000000000000000000000000000000000000000000000001
1000000000000000000000000000C0000000000000000000000000001
10000000000000C000000000000000000000000000000000000000001
1000000000000000000000000000000000000000C0000000000000001
100000000000000000000000000000000000000000000000000000001
1000000000000000000000000000000000000000C0000000000000001
100000000000000000000000000000000000000000000000000000001
111111111111111111111111111111111111111111111111111111111