111111111111111111111111111111111111111111111111111111111111111111111111111111111111111111111
100000000000000000000000000000000001000000000000000001000000000000000000000000000000000000001
10000000000000000000000000000000000100000P000000000001000000000000000000000000000000000000001
100000000000000000000000000000000001000000000000000001000000000000000000000000000000000000001
10000000000000000000000000000000000111111111111111111000000000000000000000000000000000C000001
100000000000000000000000000000000000000000000000000000000000000000000000000000000000000000001
100000000000000000000000000000000000000000000000000000000000000000000000000000000000000000001
100000000000000000000000000000000000000000000000000000000000000000000000000000000000000000001
100000000000000000000000000000000000000000000000000000000000000000000000000000000000000000001
100000000000000000000000000000000000000000000000000000000000000000000000000000000000000000001
100000000000000000000000000000000000000000000000000000000000000000000000000000000000000000001
1E0000000000000000000000000000000000000000000000000000000000000000000000000000000000000000001
111111111111111111111111111111111000000000000000000000000000000000000000000000000000000000001
100000000000000000000000000000000000000000000000000000000000000000000000000000000000000000001
100000000000000000000000000000000000000000000000000000000000000000000000000000000000000000001
100000000000000000000000000000000000000000000000000000000000000000000000000000000000000000001
10000000000C000000000000000000000000000000000000000000000000000000000C00000000000000000000001
100000000000000000000000000000000000000000000000000000000000000000000000000000000000000000001
100000000000000000000000000000000000000000000000000000000000000000000000000000000000000000001
100000000000000000000000000000000000000000000000000000000000000000000000000000000000000000001
100000000000000000000000000000000000000000000000000000000000000000000000000000000000000000001
100000000000000000000000000000000000000000000000000000000000000000000000000000000000000000001
100000000000000001111111111111111111111111111111111111111111111111111111111111111111111111111
100000000000000001000000000000000000000000000000000000000000000000000000000000000000000000001
10000000000000000100000000000000000000000000000000000000000000000000000000000C000000000000001
100000000000000001000000000000000000000000000000000000000000000000000000000000000000000000001
111111111111111111111111111111111111111111111111111111111111111111111111111111111111111111111